1111111111
1P0C000101
1010110101
1C0E110101
1000000001
100C110101
1010000101
1C00110001
1000010101
1111111111
