1111111111
1P0C000101
101011C101
1C0E110101
1000000011
100C110101
1010000101
1C00110001
10000101C1
1111111111
