11111
10X01
1PE11
11C01
11111
