11111
101E1
1P111
11C01
10001
11111
