1111111111
1P0C000101
101111C101
1C1E110101
1011100011
100C110101
1010000101
1C00110001
10000001C1
1111111111
