11111
10001
1PE11
11C01
11101
