1111111111
1000000001
1PE1110001
11C0111C01
1111111111
